"Katie Heidingsfelder"	Didn't sign out
"Scentica Trevino"	Didn't sign out
"Matt Bankert"	Didn't sign out
"Nick Kinjerski"	Didn't sign out
"Tyler Gronert"	Didn't sign out
"Steven Marr"	Didn't sign out
"John Todryk"	Didn't sign out
"Zachary Russ"	120.0
"Evans Chen"	Didn't sign out
"Levi Kilsdonk"	Didn't sign out
"Garett Paap"	Didn't sign out
"Jacob Ramsey"	Didn't sign out
"Noah Olson"	Didn't sign out
"Noah Olson"	Didn't sign out
"Nathan Leschke"	Didn't sign out
"Alex Stevenson"	Didn't sign out
"Daniel Mares"	Didn't sign out
"Caleb Slayton"	Didn't sign out
"Dylan Dibbs"	Didn't sign out
"Alex Hornung"	Didn't sign out
"Caleb Derga-Prinz"	Didn't sign out
"Michael Maas"	Didn't sign out
"Claire Mihalko"	Didn't sign out
"Hunter Bauss"	Didn't sign out
"Kaylee Wiltse"	Didn't sign out
"Alex Bacon"	Didn't sign out
"Maxwell Hinrichs"	Didn't sign out
"Aaron Leschke"	Didn't sign out
"Elizabeth Olsen"	Didn't sign out
"Matthew Schlicht"	0.12
"Alex Hornung"	Didn't sign out
"Ben Fager"	Didn't sign out
"Colby McKinley"	274.71
"Amith Aradhya"	134.59
"George Cooke"	Didn't sign out
"Terran Davis"	Didn't sign out
"Josh Hawbaker"	236.5
"Sam Watson"	64.17
"Tyler Wendt"	313.27
"Kaleb Schinschke"	151.93
"Garrett Miller"	300.66
"Chase Miller"	151.93
"Eric Siekierke"	306.45
"Nathan Keep"	153.39
"Natus El-ahrairah"	153.45
"Jordan Wendt"	283.39
"Micah Gehring"	162.3
"Jacob Lutz"	Didn't sign out
"Sean Sanders"	Didn't sign out
"Evan Tennie"	343.22
"Ryan Mares"	104.6
"Anthony Nooren"	332.06
"Fred Tutt"	199.62
"Sam Brewton"	7.16
